%%%%%%%%%%%%%%%%%%%%%%%%%%%%%%%%%%%%%%%%%%%%%%%%%%%%%%%%%%%%%%%%%%%%%%%%%%
%       % % %           %   %     % %%       % % %           %   %     % %
% %%%%%%% % %%% % %%% %%% %%%%%%% % %% %%%%%%% % %%% % %%% %%% %%%%%%% % %
%       %       % %     %     % %   %        %       % %     %     % %   %
%%%%% %%%%% %%% % % % %%% %%%%% % %%% %%%% %%%%% %%% % % % %%% %%%%% % %%%
%   % % % %   % % % %   % %   % %        % % % %   % % % %   % %   % %   %
% %%% % % % %%% %%%%% %%% % %%% %%% %% %%% % % % %%% %%%%% %%% % %%% %%% %
%       %     %   %   %     % % %   %        %     %   %   %     % % %   %
%%% %%%%%%%%% %%%%%%% %%% %%% % % % % %% %%%%%%%%% %%%%%%% %%% %%% % % % %
%             %       % %   %     % %              %       % %   %     % %
% % %%%%% % %%% % % %%% % %%% %%% % %% % %%%%% % %%% % % %%% % %%% %%% % %
% % %     % % % % %     %   % % % %    % %     % % % % %     %   % % % % %
% % % %%%%%%% % %%%%%%%%% %%% % %%% %% % % %%%%%%% % %%%%%%%%% %%% % %%% %
% % % %     %   %     %     %   %   %  % % %     %   %     %     %   %   %
%%% %%% % %%%%% %%%%% %%% %%% %%%%% %%%% %%% % %%%%% %%%%% %%% %%% %%%%% %
%     % % %     % %     % %   % % %  %     % % %     % %     % %   % % % %
% % % % % %%% %%% %%% %%% % % % % % %% % % % % %%% %%% %%% %%% % % % % % %
% % % % %                 % % %        % % % %                 % % %     %
%%% %%%%%%% % % %%%%% %%% % %%% %%%%%%%% %%%%%%% % % %%%%% %%% % %%% %%%%%
%       % % % %     %   %     % %   %%       % % % %     %   %     % %   %
%%%%% % % %%%%%%%%% %%%%%%%%%%% % %%%%%%%% % % %%%%%%%%% %%%%%%%%%%% % %%%
%   % %           % %     %   % %   %%   % %           % %     %   % %   %
% %%% %%%%% %%%%%%%%% %%%%% % % %%%  % %%% %%%%% %%%%%%%%% %%%%% % % %%% %
% %   %      %        %     %       %% %   %      %        %     %       %
% % % %%%%% %%% % % % % %%%%%%%%%%%%%% % % %%%%% %%% % % % % %%%%%%%%%%%%%
% % %   %     % % % %       %   % % %  % %   %     % % % %       %   % % %
% % %%% %%% % % % %%%%%%%%% %%% % % %% % %%% %%% % % % %%%%%%%%% %%% % % %
% %   % %   % % %   % %   % % %     %% %   % %   % % %   % %   % % %     %
% %%% %%% %%%%% %%% % % %%%%% % %%%%%% %%% %%% %%%%% %%% % % %%%%% % %%%%%
%       %   %     % %     %   % %   %%       %   %     % %     %   % %   %
%%% % %%%%% %%%%% %%% %%% % %%% % %%%%%% % %%%%% %%%%% %%% %%% % %%% % %%%
% % % % % % % %     % %   % %   % % %% % % % % % % %     % %   % %   % % %
% % %%% % % % % %%%%%%%%% % % % % % %% % %%% % % % % %%%%%%%%% % % % % % %
%   %   %   %                 %     %%   %   %   %                 %     %
% % % % %%% %%% %%%%%%% %%% %%% %%% %% % % % %%% %%% %%%%%%% %%% %%% %%% %
%.% % %       %   %       %   % %      % % %       %   %       %   % %  P%
%%%%%%%%%%%%%%%%%%%%%%%%%%%%%%%%%%%%%%%%%%%%%%%%%%%%%%%%%%%%%%%%%%%%%%%%%%